_id,AC No,AC Name,Sl no,Candidate,Party,EVM Votes,Postal Votes,Total Votes,Vote Share (%)
1,1,NERELA,2,RAJ KARAN KHATRI,Bharatiya Janata Party,86463,752,87215,49.91
2,1,NERELA,3,SHARAD KUMAR,Aam Aadmi Party,78395,224,78619,44.99
3,1,NERELA,1,ARUNA,Indian National Congress,6724,58,6782,3.88
4,1,NERELA,8,NOTA,None of the Above,973,8,981,0.56
5,1,NERELA,4,ANIL KUMAR SINGH,Communist Party of India  (Marxist-Leninist)  (Liberation),328,0,328,0.19
6,1,NERELA,7,VIKAS BHARDWAJ,Independent,300,1,301,0.17
7,1,NERELA,5,MD KHALID,Aazad Samaj Party (Kanshi Ram),278,0,278,0.16
8,1,NERELA,6,BUDIYA,Independent,242,0,242,0.14
9,2,BURARI,3,SANJEEV JHA,Aam Aadmi Party,120813,368,121181,47.57
10,2,BURARI,12,SHAILENDRA KUMAR,Janata Dal  (United),99943,637,100580,39.48
11,2,BURARI,2,MANGESH TYAGI,Indian National Congress,19808,112,19920,7.82
12,2,BURARI,10,RATAN TYAGI,Nationalist Congress Party,3829,23,3852,1.51
13,2,BURARI,15,NOTA,None of the Above,2530,18,2548,1
14,2,BURARI,1,GANGA RAM,Bahujan Samaj Party,2193,21,2214,0.87
15,2,BURARI,4,ANIL KAPOOR,Janhit Dal,866,3,869,0.34
16,2,BURARI,14,SONU KAUSHIK,Aapki Apni Party (Peoples),738,1,739,0.29
17,2,BURARI,11,VIJAY KUMAR JHA,Rachnatmak Jan Morcha,589,0,589,0.23
18,2,BURARI,13,SUNIL KUMAR VYATHIT,Aam Aadmi Sangharsh Party (S),568,1,569,0.22
19,2,BURARI,5,ABHISHEK KUMAR SINGH (MASTER JI),Rashtriya Janshakti Party (Secular),530,1,531,0.21
20,2,BURARI,6,GULAB SINGHAL,Bhim Sena,318,0,318,0.12
21,2,BURARI,8,PRAMOD,Sarvodaya Prabhat Party,315,0,315,0.12
22,2,BURARI,9,MUKESH PRASAD,Bhartiya Janta Dal (Integrated),284,4,288,0.11
23,2,BURARI,7,DHURVA KUMAR,Right to Recall Party,224,0,224,0.09
24,3,TIMARPUR,4,SURYA PRAKASH KHATRI,Bharatiya Janata Party,55626,315,55941,46.03
25,3,TIMARPUR,2,SURINDER PAL SINGH (BITTOO),Aam Aadmi Party,54602,171,54773,45.07
26,3,TIMARPUR,1,LOKENDRA KALYAN SINGH,Indian National Congress,8313,48,8361,6.88
27,3,TIMARPUR,3,SURENDER PAL,Bahujan Samaj Party,976,9,985,0.81
28,3,TIMARPUR,13,NOTA,None of the Above,658,5,663,0.55
29,3,TIMARPUR,5,TARUN KUMAR,Republican Sena,165,2,167,0.14
30,3,TIMARPUR,6,DEEPAK CHAWLA,Republican Party of India (Athawale),113,0,113,0.09
31,3,TIMARPUR,9,RAJKUMAR BHARTI,Peoples Party of India (Democratic),111,1,112,0.09
32,3,TIMARPUR,10,RAM RAJ SINGH,Rashtriya Janshakti Party (Secular),109,0,109,0.09
33,3,TIMARPUR,12,SANGH PRIYA SIDDHARTHA,Bhim Sena,107,0,107,0.09
34,3,TIMARPUR,8,RAKESH RANJAN SHRIVASTAV,Janhit Dal,90,1,91,0.07
35,3,TIMARPUR,11,WASIM AKRAM,Indian National Socialistic Action Forces,69,0,69,0.06
36,3,TIMARPUR,7,BIJENDER KUMAR,Jan Samuh Party,49,1,50,0.04
37,4,ADARSH NAGAR,3,RAJ KUMAR BHATIA,Bharatiya Janata Party,52260,250,52510,52.27
38,4,ADARSH NAGAR,2,MUKESH KUMAR GOEL,Aam Aadmi Party,40941,87,41028,40.84
39,4,ADARSH NAGAR,4,SHIVANK SINGAL,Indian National Congress,5442,18,5460,5.43
40,4,ADARSH NAGAR,15,NOTA,None of the Above,374,3,377,0.38
41,4,ADARSH NAGAR,1,ABDUL ZABBAR,Bahujan Samaj Party,343,1,344,0.34
42,4,ADARSH NAGAR,13,RAM NIWAS,Independent,140,0,140,0.14
43,4,ADARSH NAGAR,10,SANJEEV KUMAR RANA,Communist Party of India,133,0,133,0.13
44,4,ADARSH NAGAR,14,VIJAY KR. AGGARWAL,Independent,116,0,116,0.12
45,4,ADARSH NAGAR,12,NEETU SINGH,Independent,111,0,111,0.11
46,4,ADARSH NAGAR,11,AYUSH GUPTA,Independent,64,0,64,0.06
47,4,ADARSH NAGAR,5,PRIYA,"Aam Janmat Party,",56,0,56,0.06
48,4,ADARSH NAGAR,6,PREM CHAND,Rashtrawadi Janlok Party (Satya),41,0,41,0.04
49,4,ADARSH NAGAR,9,SANJAY YADAV ADVOCATE,Peoples Party of India (Democratic),35,0,35,0.03
50,4,ADARSH NAGAR,8,VISHAL SINGH,National Youth Party,27,0,27,0.03
51,4,ADARSH NAGAR,7,MD: RAHMAT ALI,Navarang Congress Party,18,0,18,0.02
52,5,BADLI,2,AAHIR DEEPAK CHAUDHARYY,Bharatiya Janata Party,61011,181,61192,40.56
53,5,BADLI,1,AJESH YADAV,Aam Aadmi Party,45937,92,46029,30.51
54,5,BADLI,3,DEVENDER YADAV,Indian National Congress,40980,91,41071,27.22
55,5,BADLI,4,RAVINDER KUMAR,Bahujan Samaj Party,723,2,725,0.48
56,5,BADLI,13,NOTA,None of the Above,687,5,692,0.46
57,5,BADLI,6,PARMOD KUMAR,Socialist Unity Centre Of India (COMMUNIST),250,0,250,0.17
58,5,BADLI,12,DEVENDER KUMAR YADAV,Independent,235,0,235,0.16
59,5,BADLI,11,JAI PAL,Independent,214,0,214,0.14
60,5,BADLI,10,ARUN KUMAR,Independent,158,0,158,0.1
61,5,BADLI,7,MULAYAM SINGH,Nationalist Congress Party,92,0,92,0.06
62,5,BADLI,5,GOPAL KUMAR SINHA,Bharatiya Sampuran Krantikari Party,76,0,76,0.05
63,5,BADLI,8,RAJENDER,"Aam Janmat Party,",68,0,68,0.05
64,5,BADLI,9,R. C. SHARMA,Sarvodaya Prabhat Party,64,0,64,0.04
65,6,RITHALA,1,KULWANT RANA,Bharatiya Janata Party,103950,421,104371,55.76
66,6,RITHALA,3,MOHINDER GOYAL,Aam Aadmi Party,74591,164,74755,39.94
67,6,RITHALA,4,SUSHANT MISHRA,Indian National Congress,5216,42,5258,2.81
68,6,RITHALA,12,NOTA,None of the Above,1224,11,1235,0.66
69,6,RITHALA,2,NEYAZ KHAN,Bahujan Samaj Party,615,4,619,0.33
70,6,RITHALA,5,ASHOK JAIN,Yuva Bharat Rashtraseva Party,213,0,213,0.11
71,6,RITHALA,10,VIDYA PATTI,Independent,167,0,167,0.09
72,6,RITHALA,8,NISHTHA,Jai Maha Bharath Party,154,1,155,0.08
73,6,RITHALA,11,VISHAL GUPTA,Independent,117,0,117,0.06
74,6,RITHALA,6,AYASHA KHATOON,Peoples Party of India (Democratic),114,0,114,0.06
75,6,RITHALA,9,AJAY KUMAR SINGH,Independent,104,0,104,0.06
76,6,RITHALA,7,JITANDER SINGH,Asankhya Samaj Party,55,1,56,0.03
77,7,BAWANA,2,RAVINDER INDRAJ SINGH,Bharatiya Janata Party,118746,769,119515,52
78,7,BAWANA,1,JAI BHAGWAN UPKAR,Aam Aadmi Party,87874,166,88040,38.3
79,7,BAWANA,3,SURENDER KUMAR,Indian National Congress,18630,83,18713,8.14
80,7,BAWANA,4,HEERA LAL,Bahujan Samaj Party,1552,5,1557,0.68
81,7,BAWANA,8,NOTA,None of the Above,1339,7,1346,0.59
82,7,BAWANA,7,HARI KISHAN MECHANIC,Independent,278,1,279,0.12
83,7,BAWANA,5,DHEERAJ KUMAR,Peoples Party of India (Democratic),216,0,216,0.09
84,7,BAWANA,6,BABITA,Asankhya Samaj Party,188,2,190,0.08
85,8,MUNDKA,1,GAJENDER DRALL,Bharatiya Janata Party,89128,711,89839,47.07
86,8,MUNDKA,2,JASBIR KARALA,Aam Aadmi Party,79062,227,79289,41.54
87,8,MUNDKA,3,DHARAMPAL LAKRA,Indian National Congress,10241,49,10290,5.39
88,8,MUNDKA,12,RAMBIR SHOKEEN,Independent,8621,34,8655,4.53
89,8,MUNDKA,14,NOTA,None of the Above,1076,12,1088,0.57
90,8,MUNDKA,4,SUMAN LATA SEHRAWAT,Bahujan Samaj Party,544,4,548,0.29
91,8,MUNDKA,13,SUNITA SHEKHAR CHAWARIYA,Independent,408,0,408,0.21
92,8,MUNDKA,7,SUNIL KUMAR,National Loktantrik Party,165,1,166,0.09
93,8,MUNDKA,11,RAJNI,Independent,128,1,129,0.07
94,8,MUNDKA,10,ANDEEP DRALL,Independent,112,3,115,0.06
95,8,MUNDKA,5,MAHAVIR,All India Forward Bloc,93,1,94,0.05
96,8,MUNDKA,6,YOGENDER SINGH ALIAS YOGI MATHUR,Akhil Bharatiya Socialist Party,86,1,87,0.05
97,8,MUNDKA,9,SANTOSH,Indian National Socialistic Action Forces,84,0,84,0.04
98,8,MUNDKA,8,SANJAYA KUMAR YADAV,Right to Recall Party,61,0,61,0.03
99,9,KIRARI,1,ANIL JHA,Aam Aadmi Party,105660,120,105780,52.26
100,9,KIRARI,3,BAJRANG SHUKLA,Bharatiya Janata Party,83749,160,83909,41.45
101,9,KIRARI,4,RAJESH KUMAR GUPTA,Indian National Congress,6847,17,6864,3.39
102,9,KIRARI,2,JUGBIR SINGH,Bahujan Samaj Party,2116,12,2128,1.05
103,9,KIRARI,10,NOTA,None of the Above,1363,3,1366,0.67
104,9,KIRARI,6,MALIK NEYAZ AHMAD,Aazad Samaj Party (Kanshi Ram),885,0,885,0.44
105,9,KIRARI,8,PRAKASH SRIVASTAV,Independent,588,0,588,0.29
106,9,KIRARI,9,RAKESH,Independent,472,1,473,0.23
107,9,KIRARI,7,SUDESH SHARMA,Rashtriya Manav Party,212,0,212,0.1
108,9,KIRARI,5,AFSANA SARWAR,Peace Party,208,0,208,0.1
109,10,SULTANPUR MAJRA,4,MUKESH KUMAR AHLAWAT,Aam Aadmi Party,58687,80,58767,52.09
110,10,SULTANPUR MAJRA,1,KARAM SINGH KARMA,Bharatiya Janata Party,41549,92,41641,36.91
111,10,SULTANPUR MAJRA,3,JAI KISHAN,Indian National Congress,8671,17,8688,7.7
112,10,SULTANPUR MAJRA,2,KULWANT RANA,Bahujan Samaj Party,1882,3,1885,1.67
113,10,SULTANPUR MAJRA,6,JITENDER,Jai Maha Bharath Party,555,0,555,0.49
114,10,SULTANPUR MAJRA,13,NOTA,None of the Above,488,6,494,0.44
115,10,SULTANPUR MAJRA,11,DEEPAK KUMAR,Independent,177,0,177,0.16
116,10,SULTANPUR MAJRA,12,RAMSWAROOP SAMRIA,Independent,150,2,152,0.13
117,10,SULTANPUR MAJRA,5,KARAN SINGH,Swaraj Bhartiya Nyay Party,151,0,151,0.13
118,10,SULTANPUR MAJRA,8,BABU LAL,Bharatiya Sampuran Krantikari Party,91,0,91,0.08
119,10,SULTANPUR MAJRA,7,PREETI,Yuva Bharat Rashtraseva Party,82,0,82,0.07
120,10,SULTANPUR MAJRA,10,SANGEETA,Rashtriya Lok Sevak Party,72,0,72,0.06
121,10,SULTANPUR MAJRA,9,LAXMI,Republican Party of India (Athawale),70,0,70,0.06
122,11,NANGLOI JAT,1,MANOJ KUMAR SHOKEEN,Bharatiya Janata Party,74950,322,75272,47.25
123,11,NANGLOI JAT,3,RAGHUVINDER SHOKEEN,Aam Aadmi Party,48907,114,49021,30.77
124,11,NANGLOI JAT,4,ROHIT CHOUDHARY,Indian National Congress,31918,110,32028,20.1
125,11,NANGLOI JAT,10,NOTA,None of the Above,915,9,924,0.58
126,11,NANGLOI JAT,2,MUKESH KUMAR,Bahujan Samaj Party,792,3,795,0.5
127,11,NANGLOI JAT,7,YATENDER SHARMA,Azad Adhikar Sena,389,1,390,0.24
128,11,NANGLOI JAT,9,DILIP KUMAR SHARMA,Independent,373,0,373,0.23
129,11,NANGLOI JAT,8,RAM SAJIVAN,Peoples Party of India (Democratic),204,1,205,0.13
130,11,NANGLOI JAT,5,KANCHAN SHARMA,Rashtriya Manav Party,162,0,162,0.1
131,11,NANGLOI JAT,6,MAHENDER SINGH RATHOR,Rashtriya Lok Sevak Party,152,0,152,0.1
132,12,MANGOL PURI,3,RAJ KUMAR CHAUHAN,Bharatiya Janata Party,61805,202,62007,50.23
133,12,MANGOL PURI,1,DHARAM RAKSHAK ALIAS RAKESH JATAV,Aam Aadmi Party,55659,93,55752,45.16
134,12,MANGOL PURI,4,HANUMAN SAHAY ALIAS HANUMAN CHAUHAN,Indian National Congress,3761,23,3784,3.07
135,12,MANGOL PURI,7,NOTA,None of the Above,760,2,762,0.62
136,12,MANGOL PURI,2,MUKESH KUMAR,Bahujan Samaj Party,721,3,724,0.59
137,12,MANGOL PURI,6,JAI BHAGWAN,Independent,250,0,250,0.2
138,12,MANGOL PURI,5,KHILKHILAKAR,Bahujan Shoshit Samaj Sangharsh Samta Party,171,0,171,0.14
139,13,ROHINI,2,VIJENDER GUPTA,Bharatiya Janata Party,69890,475,70365,65.01
140,13,ROHINI,1,PARDEEP MITTAL,Aam Aadmi Party,32442,107,32549,30.07
141,13,ROHINI,3,SUMESH GUPTA,Indian National Congress,3721,44,3765,3.48
142,13,ROHINI,9,NOTA,None of the Above,1027,4,1031,0.95
143,13,ROHINI,4,HARSHAD CHADHA,Bahujan Samaj Party,194,3,197,0.18
144,13,ROHINI,5,ABHISHEK,Jai Maha Bharath Party,118,0,118,0.11
145,13,ROHINI,6,AMIT SAINI,Jan Samuh Party,91,1,92,0.09
146,13,ROHINI,8,RAJBIR,Independent,62,0,62,0.06
147,13,ROHINI,7,NARENDER SINGH PANWAR,Independent,52,2,54,0.05
148,14,SHALIMAR BAGH,3,REKHA GUPTA,Bharatiya Janata Party,67839,361,68200,59.95
149,14,SHALIMAR BAGH,2,BANDANA KUMARI,Aam Aadmi Party,38487,118,38605,33.93
150,14,SHALIMAR BAGH,1,PARVEEN KUMAR JAIN,Indian National Congress,4845,47,4892,4.3
151,14,SHALIMAR BAGH,10,NOTA,None of the Above,768,2,770,0.68
152,14,SHALIMAR BAGH,4,SHYAM KUMAR,Bahujan Samaj Party,410,1,411,0.36
153,14,SHALIMAR BAGH,9,SAURABH GUPTA,Independent,356,2,358,0.31
154,14,SHALIMAR BAGH,8,RINA DEVI,Independent,252,0,252,0.22
155,14,SHALIMAR BAGH,7,RAJESH KUMAR,Independent,143,0,143,0.13
156,14,SHALIMAR BAGH,6,MOHD. USMAN,Independent,98,0,98,0.09
157,14,SHALIMAR BAGH,5,RANJEET VERMA,New India United Party,35,0,35,0.03
158,15,SHAKUR BASTI,1,KARNAIL SINGH,Bharatiya Janata Party,56570,299,56869,57.07
159,15,SHAKUR BASTI,3,SATYENDAR JAIN,Aam Aadmi Party,35775,96,35871,36
160,15,SHAKUR BASTI,2,SATISH KUMAR LUTHRA,Indian National Congress,5736,48,5784,5.8
161,15,SHAKUR BASTI,8,NOTA,None of the Above,672,1,673,0.68
162,15,SHAKUR BASTI,4,VIJAY KUMAR,Bahujan Samaj Party,164,0,164,0.16
163,15,SHAKUR BASTI,5,TAMANA,Yuva Bharat Rashtraseva Party,115,0,115,0.12
164,15,SHAKUR BASTI,6,RAJESH GUPTA,Bharat Lok Sewak Party,99,1,100,0.1
165,15,SHAKUR BASTI,7,JUGAL CHAWLA,Independent,76,0,76,0.08
166,16,TRI NAGAR,1,TILAK RAM GUPTA,Bharatiya Janata Party,58836,237,59073,53.36
167,16,TRI NAGAR,3,PREETI JITENDER TOMAR,Aam Aadmi Party,43083,94,43177,39
168,16,TRI NAGAR,4,SATENDER SHARMA,Indian National Congress,6867,30,6897,6.23
169,16,TRI NAGAR,7,NOTA,None of the Above,682,6,688,0.62
170,16,TRI NAGAR,2,PAWAN GARG,Bahujan Samaj Party,562,4,566,0.51
171,16,TRI NAGAR,5,SUBHASH,Asankhya Samaj Party,180,1,181,0.16
172,16,TRI NAGAR,6,SURENDRA SINGH BASOYA,Peoples Party of India (Democratic),114,1,115,0.1
173,17,WAZIRPUR,1,POONAM SHARMA,Bharatiya Janata Party,54414,307,54721,51.24
174,17,WAZIRPUR,3,RAJESH GUPTA,Aam Aadmi Party,43194,102,43296,40.54
175,17,WAZIRPUR,2,RAGINI NAYAK,Indian National Congress,6311,37,6348,5.94
176,17,WAZIRPUR,4,HIRA LAL,Bahujan Samaj Party,1046,1,1047,0.98
177,17,WAZIRPUR,10,NOTA,None of the Above,652,0,652,0.61
178,17,WAZIRPUR,8,AAKASH GOEL,Independent,233,1,234,0.22
179,17,WAZIRPUR,5,DEVENDER KUMAR,Communist Party of India,190,0,190,0.18
180,17,WAZIRPUR,9,MUKESH JAIN,Independent,173,0,173,0.16
181,17,WAZIRPUR,6,MAHESH BANSAL,Right to Recall Party,64,0,64,0.06
182,17,WAZIRPUR,7,SHEELA DEVI,Garib Ekta Party,63,0,63,0.06
183,18,MODEL TOWN,2,ASHOK GOEL,Bharatiya Janata Party,51848,260,52108,54.1
184,18,MODEL TOWN,1,AKHILESH PATI TRIPATHI,Aam Aadmi Party,38608,85,38693,40.17
185,18,MODEL TOWN,3,KANWAR KARAN SINGH,Indian National Congress,3886,22,3908,4.06
186,18,MODEL TOWN,10,NOTA,None of the Above,682,3,685,0.71
187,18,MODEL TOWN,4,CHUNNI LAL,Bahujan Samaj Party,372,0,372,0.39
188,18,MODEL TOWN,9,ROMAN RASHID,Independent,224,0,224,0.23
189,18,MODEL TOWN,8,CHANDER PAL,Independent,119,0,119,0.12
190,18,MODEL TOWN,7,VIVEK GIRI,Aapki Apni Party (Peoples),118,0,118,0.12
191,18,MODEL TOWN,6,PANKAJ KUMAR,Rashtravadi Janata Party,58,0,58,0.06
192,18,MODEL TOWN,5,AWDHESH KUMAR JHA,Right to Recall Party,33,0,33,0.03
193,19,SADAR BAZAR,4,SOM DUTT,Aam Aadmi Party,56070,107,56177,47.45
194,19,SADAR BAZAR,2,MANOJ KUMAR JINDAL,Bharatiya Janata Party,49671,199,49870,42.12
195,19,SADAR BAZAR,1,ANIL BHARDWAJ,Indian National Congress,10022,35,10057,8.49
196,19,SADAR BAZAR,3,SHAIL KUMARI,Bahujan Samaj Party,708,1,709,0.6
197,19,SADAR BAZAR,12,NOTA,None of the Above,584,2,586,0.49
198,19,SADAR BAZAR,9,MEENAKSHI KUMARI,Bharatiya Liberal Party,247,0,247,0.21
199,19,SADAR BAZAR,8,MADHU BALA,Jai Maha Bharath Party,213,0,213,0.18
200,19,SADAR BAZAR,6,ASHA RANI,Socialist Unity Centre Of India (COMMUNIST),184,0,184,0.16
201,19,SADAR BAZAR,5,ANITA BANSAL,Asankhya Samaj Party,123,0,123,0.1
202,19,SADAR BAZAR,11,CA SOHARSH GULGULIA JAIN,Jantantrik Samta Party,100,0,100,0.08
203,19,SADAR BAZAR,10,LAXMI THAKUR SINGHAL,Abhinav Bharat Party,84,0,84,0.07
204,19,SADAR BAZAR,7,UMESH RATHOR,Atulya Bharat Party,49,1,50,0.04
205,20,CHANDNI CHOWK,2,PUNARDEEP SINGH SAWHNEY (SABBY),Aam Aadmi Party,38932,61,38993,54.79
206,20,CHANDNI CHOWK,4,SATISH JAIN,Bharatiya Janata Party,22359,62,22421,31.5
207,20,CHANDNI CHOWK,3,MUDIT AGARWAL,Indian National Congress,9038,27,9065,12.74
208,20,CHANDNI CHOWK,8,NOTA,None of the Above,249,4,253,0.36
209,20,CHANDNI CHOWK,1,KALI CHARAN,Bahujan Samaj Party,246,0,246,0.35
210,20,CHANDNI CHOWK,5,KHALID UR REHMAN,Nationalist Congress Party,81,0,81,0.11
211,20,CHANDNI CHOWK,7,RAHUL TIWARI,Right to Recall Party,69,0,69,0.1
212,20,CHANDNI CHOWK,6,MOHAMMAD MURSALEEN,Indian National Socialistic Action Forces,45,0,45,0.06
213,21,MATIA MAHAL,1,AALEY MOHAMMED IQBAL,Aam Aadmi Party,58041,79,58120,68.8
214,21,MATIA MAHAL,4,DEEPTI INDORA,Bharatiya Janata Party,15351,45,15396,18.23
215,21,MATIA MAHAL,2,ASIM AHMED KHAN,Indian National Congress,10274,21,10295,12.19
216,21,MATIA MAHAL,12,NOTA,None of the Above,217,0,217,0.26
217,21,MATIA MAHAL,3,TEJ RAM,Bahujan Samaj Party,129,1,130,0.15
218,21,MATIA MAHAL,6,AMAR NATH,Independent,93,0,93,0.11
219,21,MATIA MAHAL,10,MOHAMMAD AHMED SAIFI,Independent,60,0,60,0.07
220,21,MATIA MAHAL,5,MOHD JAVED,Nationalist Congress Party,56,0,56,0.07
221,21,MATIA MAHAL,9,BHAGWAN DASS,Independent,35,0,35,0.04
222,21,MATIA MAHAL,8,FIRDOUS AHMAD,Independent,31,0,31,0.04
223,21,MATIA MAHAL,11,MOAZAM KHAN,Independent,31,0,31,0.04
224,21,MATIA MAHAL,7,ZAINUDDIN,Independent,10,1,11,0.01
225,22,BALLIMARAN,1,IMRAN HUSSAIN,Aam Aadmi Party,56932,72,57004,58
226,22,BALLIMARAN,2,KAMAL BAGRI,Bharatiya Janata Party,27119,62,27181,27.66
227,22,BALLIMARAN,4,HAROON YUSUF,Indian National Congress,13038,21,13059,13.29
228,22,BALLIMARAN,10,NOTA,None of the Above,299,2,301,0.31
229,22,BALLIMARAN,5,ABRAR,Aam Aadmi Parivartan Party,224,0,224,0.23
230,22,BALLIMARAN,3,SONU,Bahujan Samaj Party,190,0,190,0.19
231,22,BALLIMARAN,7,BABU LAL,Independent,130,1,131,0.13
232,22,BALLIMARAN,9,HANSA,Independent,77,0,77,0.08
233,22,BALLIMARAN,8,MOHD. SHADAB,Independent,72,0,72,0.07
234,22,BALLIMARAN,6,MD HAROON,Nationalist Congress Party,38,0,38,0.04
235,23,KAROL BAGH,4,VISHESH RAVI,Aam Aadmi Party,52153,144,52297,50.88
236,23,KAROL BAGH,1,DUSHYANT GAUTAM,Bharatiya Janata Party,44750,117,44867,43.65
237,23,KAROL BAGH,2,RAHUL KUMAR,Indian National Congress,4232,20,4252,4.14
238,23,KAROL BAGH,3,RANJEET,Bahujan Samaj Party,624,2,626,0.61
239,23,KAROL BAGH,7,NOTA,None of the Above,543,5,548,0.53
240,23,KAROL BAGH,5,SHIV KUMAR,Rashtriya Aikta Manch Party,116,0,116,0.11
241,23,KAROL BAGH,6,DEEPAK KUMAR,Independent,87,1,88,0.09
242,24,PATEL NAGAR,2,PRAVESH RATN,Aam Aadmi Party,57408,104,57512,49
243,24,PATEL NAGAR,3,RAAJ KUMAR ANAND,Bharatiya Janata Party,53273,190,53463,45.55
244,24,PATEL NAGAR,1,KRISHNA TIRATH,Indian National Congress,4610,44,4654,3.97
245,24,PATEL NAGAR,6,NOTA,None of the Above,768,4,772,0.66
246,24,PATEL NAGAR,4,RAM AVTAR,Bahujan Samaj Party,712,2,714,0.61
247,24,PATEL NAGAR,5,ASHOK KUMAR,Aazad Samaj Party (Kanshi Ram),255,0,255,0.22
248,25,MOTI NAGAR,4,HARISH KHURANA,Bharatiya Janata Party,57364,201,57565,52.64
249,25,MOTI NAGAR,3,SHIVCHARAN GOEL,Aam Aadmi Party,45827,81,45908,41.98
250,25,MOTI NAGAR,2,RAJENDER SINGH,Indian National Congress,3316,18,3334,3.05
251,25,MOTI NAGAR,1,AVINASH GUPTA,Bahujan Samaj Party,848,3,851,0.78
252,25,MOTI NAGAR,13,NOTA,None of the Above,687,2,689,0.63
253,25,MOTI NAGAR,11,SADRE ALAM,Independent,415,1,416,0.38
254,25,MOTI NAGAR,10,GAURI SHANKAR,Independent,170,0,170,0.16
255,25,MOTI NAGAR,5,GOURAV BOTHRA,Right to Recall Party,124,0,124,0.11
256,25,MOTI NAGAR,12,HARISH,Independent,76,0,76,0.07
257,25,MOTI NAGAR,8,VISHAL SAHNI,Voters Party  International,70,0,70,0.06
258,25,MOTI NAGAR,7,VIJAY KUMAR SHARMA,Rashtriya Manav Party,63,0,63,0.06
259,25,MOTI NAGAR,9,SANAULLAH,Nationalist Congress Party,60,0,60,0.05
260,25,MOTI NAGAR,6,MAHESH DUBEY,Bharatiya Liberal Party,35,0,35,0.03
261,26,MADIPUR,1,KAILASH GANGWAL,Bharatiya Janata Party,51824,195,52019,46.08
262,26,MADIPUR,3,RAKHI BIRLA,Aam Aadmi Party,41034,86,41120,36.42
263,26,MADIPUR,2,J. P. PANWAR,Indian National Congress,17878,80,17958,15.91
264,26,MADIPUR,10,NOTA,None of the Above,773,5,778,0.69
265,26,MADIPUR,4,ROOP SINGH AHIRWAR,Bahujan Samaj Party,319,2,321,0.28
266,26,MADIPUR,8,DHARAMVEER,Independent,206,0,206,0.18
267,26,MADIPUR,6,RANDHIR SINGH TANDI,Jai Maha Bharath Party,204,0,204,0.18
268,26,MADIPUR,9,RAVI,Independent,113,0,113,0.1
269,26,MADIPUR,7,ROHIT KASHYAP,Hamara Sahi Vikalp Party,105,0,105,0.09
270,26,MADIPUR,5,RANDHIR KUMAR,Asankhya Samaj Party,66,0,66,0.06
271,27,RAJOURI GARDEN,3,MANJINDER SINGH SIRSA,Bharatiya Janata Party,63883,249,64132,55.86
272,27,RAJOURI GARDEN,1,A DHANWATI CHANDELA A,Aam Aadmi Party,45835,107,45942,40.02
273,27,RAJOURI GARDEN,2,DHARAM PAL CHANDELA,Indian National Congress,3171,27,3198,2.79
274,27,RAJOURI GARDEN,9,NOTA,None of the Above,778,5,783,0.68
275,27,RAJOURI GARDEN,4,SHASHI PABHA,Bahujan Samaj Party,286,2,288,0.25
276,27,RAJOURI GARDEN,6,KARAN TALWAR,Aam Aadmi Parivartan Party,225,0,225,0.2
277,27,RAJOURI GARDEN,7,JAYA RAMAN,Sanjhi Virasat Party,89,0,89,0.08
278,27,RAJOURI GARDEN,8,VISHAL SANGWAN,Right to Recall Party,84,0,84,0.07
279,27,RAJOURI GARDEN,5,KAMLA DEVI,Aapki Apni Party (Peoples),64,1,65,0.06
280,28,HARI NAGAR,3,SHYAM SHARMA,Bharatiya Janata Party,49608,571,50179,48.7
281,28,HARI NAGAR,4,SURINDER KUMAR SETIA,Aam Aadmi Party,43262,285,43547,42.26
282,28,HARI NAGAR,1,PREM BALLABH,Indian National Congress,4175,77,4252,4.13
283,28,HARI NAGAR,9,RAJ KUMARI DHILLON,Independent,3367,31,3398,3.3
284,28,HARI NAGAR,11,NOTA,None of the Above,705,8,713,0.69
285,28,HARI NAGAR,2,BINDU KUMAR,Bahujan Samaj Party,566,3,569,0.55
286,28,HARI NAGAR,8,MAYANK MEHTA,Independent,98,0,98,0.1
287,28,HARI NAGAR,10,SABIR KHAN,Independent,89,2,91,0.09
288,28,HARI NAGAR,6,MOHAN LAL BHARDWAJ,Bharatheeya Jawan Kisan Party,83,0,83,0.08
289,28,HARI NAGAR,5,PREETAM CHAND,Rashtriya Janshakti Party (Secular),81,0,81,0.08
290,28,HARI NAGAR,7,ASHOK KUMAR,Independent,28,1,29,0.03
291,29,TILAK NAGAR,2,JARNAIL SINGH,Aam Aadmi Party,51955,179,52134,54.02
292,29,TILAK NAGAR,4,SHVETA SAINI,Bharatiya Janata Party,40233,245,40478,41.94
293,29,TILAK NAGAR,3,PARVINDER SINGH ALIAS P S BAWA,Indian National Congress,2716,31,2747,2.85
294,29,TILAK NAGAR,7,NOTA,None of the Above,600,7,607,0.63
295,29,TILAK NAGAR,1,ASHOK KUMAR GAUTAM,Bahujan Samaj Party,296,5,301,0.31
296,29,TILAK NAGAR,6,SHWETA,Independent,145,0,145,0.15
297,29,TILAK NAGAR,5,RAJIV KUMAR BABBAR,Independent,91,0,91,0.09
298,30,JANAKPURI,1,ASHISH SOOD,Bharatiya Janata Party,68564,422,68986,55.27
299,30,JANAKPURI,2,PARVEEN KUMAR,Aam Aadmi Party,50045,175,50220,40.23
300,30,JANAKPURI,4,HARBANI KAUR,Indian National Congress,3305,40,3345,2.68
301,30,JANAKPURI,17,NOTA,None of the Above,684,7,691,0.55
302,30,JANAKPURI,3,RAVI PARTAP RAO,Bahujan Samaj Party,458,3,461,0.37
303,30,JANAKPURI,16,PRAVEEN KUMAR,Independent,210,0,210,0.17
304,30,JANAKPURI,15,PRAVEEN KUMAR,Independent,193,0,193,0.15
305,30,JANAKPURI,12,ALTAF AHMAD,Independent,182,1,183,0.15
306,30,JANAKPURI,10,MOHD OJER,Azad Adhikar Sena,91,0,91,0.07
307,30,JANAKPURI,8,MD NAVEEN,Nationalist Congress Party,80,0,80,0.06
308,30,JANAKPURI,6,CHAMAN LAL VERMA,Aam Janshakti Party,69,1,70,0.06
309,30,JANAKPURI,7,DHARAM VEER,Suheldev Bharatiya Samaj Party,61,0,61,0.05
310,30,JANAKPURI,14,TARUN KUMAR SHARMA,Independent,60,0,60,0.05
311,30,JANAKPURI,13,ASHISH SOOD,Independent,56,1,57,0.05
312,30,JANAKPURI,5,KASHMIR CHAND,Buland Bharat Party,47,1,48,0.04
313,30,JANAKPURI,9,NIZAMUDDIN KHAN,Adarshwaadi Congress Party,43,0,43,0.03
314,30,JANAKPURI,11,RAJ KUMAR,All India National Raksha Sena,20,0,20,0.02
315,31,VIKASPURI,3,PANKAJ KUMAR SINGH,Bharatiya Janata Party,135038,526,135564,49.54
316,31,VIKASPURI,4,MAHINDER YADAV,Aam Aadmi Party,122419,269,122688,44.83
317,31,VIKASPURI,2,JITENDER SOLANKI,Indian National Congress,8397,68,8465,3.09
318,31,VIKASPURI,1,KRISHNA THAKUR,Bahujan Samaj Party,2632,10,2642,0.97
319,31,VIKASPURI,14,NOTA,None of the Above,1452,8,1460,0.53
320,31,VIKASPURI,11,SHEJO VARGHESE,Communist Party of India,685,2,687,0.25
321,31,VIKASPURI,5,UMESH CHAUHAN,Aazad Samaj Party (Kanshi Ram),443,0,443,0.16
322,31,VIKASPURI,10,SHARDA DIXIT,Socialist Unity Centre Of India (COMMUNIST),420,0,420,0.15
323,31,VIKASPURI,13,HIRA LAL SAH,Independent,390,1,391,0.14
324,31,VIKASPURI,9,LALA RAM,Bhartiya Panchsheel Party,297,0,297,0.11
325,31,VIKASPURI,12,AMAN SAINI,Independent,286,0,286,0.1
326,31,VIKASPURI,8,RANJEET KUMAR,Rashtriya Manav Party,139,0,139,0.05
327,31,VIKASPURI,6,PREM PAL SINGH,Rashtriya Janshakti Party (Secular),97,0,97,0.04
328,31,VIKASPURI,7,RAJU RICHARIYA,Rashtriya Rashtrawadi Party,69,0,69,0.03
329,32,UTTAM NAGAR,1,PAWAN SHARMA,Bharatiya Janata Party,103137,476,103613,52.84
330,32,UTTAM NAGAR,2,POSH BALYAN,Aam Aadmi Party,73705,168,73873,37.67
331,32,UTTAM NAGAR,4,MUKESH SHARMA,Indian National Congress,15474,91,15565,7.94
332,32,UTTAM NAGAR,10,NOTA,None of the Above,1209,8,1217,0.62
333,32,UTTAM NAGAR,3,MANI RAM,Bahujan Samaj Party,983,8,991,0.51
334,32,UTTAM NAGAR,8,DINESH KUMAR SAH,Independent,204,2,206,0.11
335,32,UTTAM NAGAR,9,JOURNALIST RAMESH KUMAR JAIN @ NIRBHIK,Independent,196,0,196,0.1
336,32,UTTAM NAGAR,5,DUSHYANT THAKUR,Yuva Bharat Rashtraseva Party,185,0,185,0.09
337,32,UTTAM NAGAR,7,SHYAM BABU,Gareeb Aadmi Party,168,0,168,0.09
338,32,UTTAM NAGAR,6,RAJIV BHRIGUKUMAR,Rashtriya Lok Janshakti Party,79,0,79,0.04
339,33,DWARKA,3,PARDUYMN SINGH RAJPUT,Bharatiya Janata Party,68832,305,69137,49.56
340,33,DWARKA,4,VINAY MISHRA,Aam Aadmi Party,61136,172,61308,43.95
341,33,DWARKA,1,ADARSH SHASTRI,Indian National Congress,6723,50,6773,4.86
342,33,DWARKA,14,NOTA,None of the Above,725,4,729,0.52
343,33,DWARKA,2,PARDEEP KUMAR,Bahujan Samaj Party,541,4,545,0.39
344,33,DWARKA,11,RAMESHWAR MAHTO,Rashtriya Manav Party,223,0,223,0.16
345,33,DWARKA,12,ASHOK JINDAL,Independent,172,0,172,0.12
346,33,DWARKA,5,ARAVENDRA KUMAR,Suheldev Bharatiya Samaj Party,131,0,131,0.09
347,33,DWARKA,9,RAJNEESH KUMAR JHA,National Youth Party,130,0,130,0.09
348,33,DWARKA,13,GAUTAM SINGH BIHARI,Independent,104,0,104,0.07
349,33,DWARKA,7,MEHAR CHARAN,Samaj Vikas Kranti Party,76,0,76,0.05
350,33,DWARKA,10,RAVI RATHORE,Republican Sena,73,1,74,0.05
351,33,DWARKA,6,G. THULASEEDHARAN,Peoples Green Party,58,0,58,0.04
352,33,DWARKA,8,YOGESH SWAMI,Right to Recall Party,44,0,44,0.03
353,34,MATIALA,4,SANDEEP SEHRAWAT,Bharatiya Janata Party,144938,1357,146295,52.46
354,34,MATIALA,3,SUMESH SHOKEEN,Aam Aadmi Party,117042,530,117572,42.16
355,34,MATIALA,2,RAGHVINDER SINGH,Indian National Congress,9565,120,9685,3.47
356,34,MATIALA,14,NOTA,None of the Above,1994,24,2018,0.72
357,34,MATIALA,1,KAMLESH KUMAR,Bahujan Samaj Party,1116,18,1134,0.41
358,34,MATIALA,12,YOGESH KUMAR,Independent,569,0,569,0.2
359,34,MATIALA,11,PUNAM PANDEY,Independent,498,3,501,0.18
360,34,MATIALA,5,ARVIND KUMAR PANDEY,Rashtriya Janshakti Party (Secular),345,0,345,0.12
361,34,MATIALA,13,RAJNI SHARMA,Independent,174,0,174,0.06
362,34,MATIALA,7,PRABHAT KUMAR,One Bharat Citizen Party,157,5,162,0.06
363,34,MATIALA,10,VINOD KUMAR CHAUHAN,Suheldev Bharatiya Samaj Party,156,1,157,0.06
364,34,MATIALA,9,YOGESH KUMAR SHARMA,Right to Recall Party,121,0,121,0.04
365,34,MATIALA,8,MOHINDER SINGH,Rashtriya Rashtrawadi Party,88,0,88,0.03
366,34,MATIALA,6,NIRAJ KUMAR,National Youth Party,73,0,73,0.03
367,35,NAJAFGARH,2,NEELAM PAHALWAN,Bharatiya Janata Party,100058,1650,101708,56.4
368,35,NAJAFGARH,1,TARUN KUMAR,Aam Aadmi Party,72024,675,72699,40.31
369,35,NAJAFGARH,4,SUSHMA DEVI YADAV,Indian National Congress,2839,63,2902,1.61
370,35,NAJAFGARH,10,NOTA,None of the Above,1317,29,1346,0.75
371,35,NAJAFGARH,3,ROHIT,Bahujan Samaj Party,873,30,903,0.5
372,35,NAJAFGARH,9,MANGE RAM SANGWAN,Independent,222,3,225,0.12
373,35,NAJAFGARH,5,JALANDHAR PANDIT,"Proutist Bloc, India",210,4,214,0.12
374,35,NAJAFGARH,8,MANOJ KUMAR,Independent,173,0,173,0.1
375,35,NAJAFGARH,6,BHARAT SINGH,Peoples Party of India (Democratic),88,5,93,0.05
376,35,NAJAFGARH,7,RAHUL KUMAR,Right to Recall Party,70,1,71,0.04
377,36,BIJWASAN,2,KAILASH GAHLOT,Bharatiya Janata Party,64587,364,64951,49.77
378,36,BIJWASAN,4,SURENDER BHARDWAJ,Aam Aadmi Party,53462,213,53675,41.13
379,36,BIJWASAN,3,COL DEVINDER KUMAR SEHRAWAT,Indian National Congress,9334,75,9409,7.21
380,36,BIJWASAN,13,NOTA,None of the Above,755,1,756,0.58
381,36,BIJWASAN,1,KAMAL SINGH,Bahujan Samaj Party,698,4,702,0.54
382,36,BIJWASAN,11,MONIS KURESHI,Independent,225,0,225,0.17
383,36,BIJWASAN,10,NISHANT SEHRAWAT,Independent,192,1,193,0.15
384,36,BIJWASAN,7,PUNAM PANDEY,Rashtravadi Loktantrik Party (India),153,0,153,0.12
385,36,BIJWASAN,9,AMRINA,Independent,113,0,113,0.09
386,36,BIJWASAN,5,NARENDER SINGH,Republican Sena,96,0,96,0.07
387,36,BIJWASAN,12,SOM DUTT SHARMA,Independent,91,1,92,0.07
388,36,BIJWASAN,6,NAVEEN KUMAR,Hamara Sahi Vikalp Party,91,0,91,0.07
389,36,BIJWASAN,8,LALITA TRIVEDI,Bhartiya Krishak Dal,48,0,48,0.04
390,37,PALAM,1,KULDEEP SOLANKI,Bharatiya Janata Party,81589,457,82046,50.45
391,37,PALAM,3,JOGINDER SOLANKI,Aam Aadmi Party,72844,250,73094,44.95
392,37,PALAM,4,MANGE RAM,Indian National Congress,4655,42,4697,2.89
393,37,PALAM,8,NOTA,None of the Above,1109,10,1119,0.69
394,37,PALAM,2,GEETA,Bahujan Samaj Party,805,5,810,0.5
395,37,PALAM,5,DILIP KUMAR,Communist Party of India,325,1,326,0.2
396,37,PALAM,7,PRASHANT CHAUHAN,Independent,301,1,302,0.19
397,37,PALAM,6,MANU GAUTAM,Peoples Party of India (Democratic),220,1,221,0.14
398,38,DELHI CANTT,4,VIRENDER SINGH KADIAN,Aam Aadmi Party,22140,51,22191,46.76
399,38,DELHI CANTT,3,BHUVAN TANWAR,Bharatiya Janata Party,20073,89,20162,42.48
400,38,DELHI CANTT,2,PRADEEP KUMAR UPMANYU,Indian National Congress,4230,22,4252,8.96
401,38,DELHI CANTT,8,NOTA,None of the Above,327,3,330,0.7
402,38,DELHI CANTT,1,NAMIT KUMAR GAUTAM,Bahujan Samaj Party,232,0,232,0.49
403,38,DELHI CANTT,7,ASHOK AGYANI,Independent,149,0,149,0.31
404,38,DELHI CANTT,6,SURENDER KUMAR,Peoples Party of India (Democratic),72,0,72,0.15
405,38,DELHI CANTT,5,SACHIN,Bharatiya Sampuran Krantikari Party,70,0,70,0.15
406,39,RAJINDER NAGAR,1,UMANG BAJAJ,Bharatiya Janata Party,46391,280,46671,48.01
407,39,RAJINDER NAGAR,2,DURGESH PATHAK,Aam Aadmi Party,45290,150,45440,46.74
408,39,RAJINDER NAGAR,3,VINEET YADAV,Indian National Congress,3995,20,4015,4.13
409,39,RAJINDER NAGAR,8,NOTA,None of the Above,565,6,571,0.59
410,39,RAJINDER NAGAR,6,PRAVEEN KUMAR BHARTI,Aazad Samaj Party (Kanshi Ram),155,0,155,0.16
411,39,RAJINDER NAGAR,4,SHIV PRASAD VERMA,Bahujan Samaj Party,147,3,150,0.15
412,39,RAJINDER NAGAR,7,UMANG,Independent,143,1,144,0.15
413,39,RAJINDER NAGAR,5,PANKAJ JAGYA,Republican Party of India (Athawale),65,0,65,0.07
414,40,NEW DELHI,2,PARVESH SAHIB SINGH,Bharatiya Janata Party,29878,210,30088,48.82
415,40,NEW DELHI,1,ARVIND KEJRIWAL,Aam Aadmi Party,25865,134,25999,42.18
416,40,NEW DELHI,4,SANDEEP DIKSHIT,Indian National Congress,4531,37,4568,7.41
417,40,NEW DELHI,24,NOTA,None of the Above,306,8,314,0.51
418,40,NEW DELHI,3,VIRENDER,Bahujan Samaj Party,142,0,142,0.23
419,40,NEW DELHI,12,DR. MUNISH KUMAR RAIZADA,Bharatiya Liberal Party,75,1,76,0.12
420,40,NEW DELHI,18,ANURADHA RANA,Independent,72,0,72,0.12
421,40,NEW DELHI,17,ANITA,Independent,55,0,55,0.09
422,40,NEW DELHI,16,SANTOSH RAI,Abhinav Bharat Party,53,0,53,0.09
423,40,NEW DELHI,8,DUGGIRALA NAGESWARA RAO,Jatiya Jana Sena Party,39,0,39,0.06
424,40,NEW DELHI,9,NARESH KUMAR,Aapki Apni Party (Peoples),37,0,37,0.06
425,40,NEW DELHI,19,DR. ABHILASHA,Independent,31,0,31,0.05
426,40,NEW DELHI,15,SANTOSH KUMAR,Right to Recall Party,30,0,30,0.05
427,40,NEW DELHI,7,JAGDEESH PRASAD,Samarth Bharatvarsh Party,22,0,22,0.04
428,40,NEW DELHI,5,ARUN KUMAR SHARMA,Delhi Janta Party,21,0,21,0.03
429,40,NEW DELHI,22,SANJAY RAWAT,Independent,16,1,17,0.03
430,40,NEW DELHI,13,RAVINDER SINGH RAWAT,Haryana Jansena Party,14,1,15,0.02
431,40,NEW DELHI,21,BHAWANA,Independent,11,0,11,0.02
432,40,NEW DELHI,20,PANKAJ SHARMA,Independent,9,0,9,0.01
433,40,NEW DELHI,23,HAIDER ALI,Independent,9,0,9,0.01
434,40,NEW DELHI,10,NITYA NAND SINGH,Rashtriya Manav Party,8,0,8,0.01
435,40,NEW DELHI,11,MUKESH JAIN,Rashtrawadi Janlok Party (Satya),8,0,8,0.01
436,40,NEW DELHI,14,SANGHA NAND BAUDDH,Bhim Sena,8,0,8,0.01
437,40,NEW DELHI,6,ISHWAR CHAND,Bharatrashtra Democratic Party,4,0,4,0.01
438,41,JANGPURA,1,TARVINDER SINGH MARWAH,Bharatiya Janata Party,38675,184,38859,45.44
439,41,JANGPURA,3,MANISH SISODIA,Aam Aadmi Party,38081,103,38184,44.65
440,41,JANGPURA,2,FARHAD SURI,Indian National Congress,7324,26,7350,8.6
441,41,JANGPURA,10,NOTA,None of the Above,438,3,441,0.52
442,41,JANGPURA,8,ASHOK BAMBANI,Independent,170,1,171,0.2
443,41,JANGPURA,4,RAVINDRA SINGH RAVIYODAYA,Bahujan Samaj Party,154,1,155,0.18
444,41,JANGPURA,6,BIJENDER,Haryana Jansena Party,119,0,119,0.14
445,41,JANGPURA,9,SUNIL KUMAR KUKREJA,Independent,80,0,80,0.09
446,41,JANGPURA,7,RAKESH SAGAR,Blue India Party,78,0,78,0.09
447,41,JANGPURA,5,ANIL KUMAR,Bhartiya Rashtrawadi Party,74,0,74,0.09
448,42,KASTURBA NAGAR,2,NEERAJ BASOYA,Bharatiya Janata Party,37896,171,38067,45.06
449,42,KASTURBA NAGAR,1,ABHISHEK DUTT,Indian National Congress,26918,101,27019,31.98
450,42,KASTURBA NAGAR,4,RAMESH PAHELWAN,Aam Aadmi Party,18558,59,18617,22.04
451,42,KASTURBA NAGAR,6,NOTA,None of the Above,470,2,472,0.56
452,42,KASTURBA NAGAR,5,PARTEEK GUPTA,Independent,157,1,158,0.19
453,42,KASTURBA NAGAR,3,MAHESH KUMAR,Bahujan Samaj Party,149,1,150,0.18
454,43,MALVIYA NAGAR,3,SATISH UPADHYAY,Bharatiya Janata Party,39216,348,39564,46.53
455,43,MALVIYA NAGAR,4,SOMNATH BHARTI,Aam Aadmi Party,37280,153,37433,44.02
456,43,MALVIYA NAGAR,2,JITENDER KUMAR KOCHAR,Indian National Congress,6734,36,6770,7.96
457,43,MALVIYA NAGAR,8,NOTA,None of the Above,526,6,532,0.63
458,43,MALVIYA NAGAR,1,CHARANJEET KAUR,Bahujan Samaj Party,237,1,238,0.28
459,43,MALVIYA NAGAR,7,MEGHNAD S.,Independent,192,0,192,0.23
460,43,MALVIYA NAGAR,6,DR. BHUPENDRA CHAURASIYA,Yuva Bharat Rashtraseva Party,162,0,162,0.19
461,43,MALVIYA NAGAR,5,BHAVISH DHANKAR,Bhartiya Rashtriya Jansatta,144,0,144,0.17
462,44,R. K. PURAM,1,ANIL KUMAR SHARMA,Bharatiya Janata Party,42965,295,43260,56.55
463,44,R. K. PURAM,2,PRAMILA TOKAS,Aam Aadmi Party,28652,155,28807,37.65
464,44,R. K. PURAM,3,VISHESH KUMAR,Indian National Congress,3048,31,3079,4.02
465,44,R. K. PURAM,14,NOTA,None of the Above,545,4,549,0.72
466,44,R. K. PURAM,4,SUNIL KAIN,Bahujan Samaj Party,202,0,202,0.26
467,44,R. K. PURAM,12,RAMESH ADVOCATE,Independent,100,0,100,0.13
468,44,R. K. PURAM,6,NEERAJ CHOURASIYA,Yuva Bharat Rashtraseva Party,99,0,99,0.13
469,44,R. K. PURAM,11,PERMILA,Independent,87,1,88,0.12
470,44,R. K. PURAM,7,LOKESH KUMAR MASTERJI,Rashtriya Rashtrawadi Party,76,0,76,0.1
471,44,R. K. PURAM,13,RAI SINGH,Independent,76,0,76,0.1
472,44,R. K. PURAM,10,KULDEEP SINGH AHLAWAT,Independent,55,0,55,0.07
473,44,R. K. PURAM,8,VIJAY KUMAR,Peoples Party of India (Democratic),52,0,52,0.07
474,44,R. K. PURAM,9,SARAVANAN,Rashtriya Manav Party,35,0,35,0.05
475,44,R. K. PURAM,5,ABHA JHA,Bhartiya Mahasangh Party,25,0,25,0.03
476,45,MEHRAULI,1,GAJENDER SINGH YADAV,Bharatiya Janata Party,48022,327,48349,41.67
477,45,MEHRAULI,3,MAHENDER CHAUDHARY,Aam Aadmi Party,46426,141,46567,40.13
478,45,MEHRAULI,8,BALYOGI BABA BALAKNATH,Independent,9685,46,9731,8.39
479,45,MEHRAULI,2,PUSHPA SINGH,Indian National Congress,9250,88,9338,8.05
480,45,MEHRAULI,9,NOTA,None of the Above,840,6,846,0.73
481,45,MEHRAULI,4,YOGESHWAR SINGH BISHT,Bahujan Samaj Party,771,7,778,0.67
482,45,MEHRAULI,5,MAHAVIR SINGH,Matrubhoomi Sewa Party,181,0,181,0.16
483,45,MEHRAULI,7,SHARDA SINGH,Right to Recall Party,140,0,140,0.12
484,45,MEHRAULI,6,VIJAY LAL TAMTA,Peoples Party of India (Democratic),104,0,104,0.09
485,46,CHHATARPUR,1,KARTAR SINGH TANWAR,Bharatiya Janata Party,80128,341,80469,48.98
486,46,CHHATARPUR,3,BRAHM SINGH TANWAR,Aam Aadmi Party,74029,201,74230,45.18
487,46,CHHATARPUR,4,RAJENDER SINGH TANWAR,Indian National Congress,6550,51,6601,4.02
488,46,CHHATARPUR,12,NOTA,None of the Above,862,6,868,0.53
489,46,CHHATARPUR,2,BRIJ LAL,Bahujan Samaj Party,739,11,750,0.46
490,46,CHHATARPUR,7,DINESH TANWAR,Aapki Apni Party (Peoples),293,0,293,0.18
491,46,CHHATARPUR,10,DHARMENDER,Independent,268,1,269,0.16
492,46,CHHATARPUR,11,SANJAY NEGI,Independent,220,1,221,0.13
493,46,CHHATARPUR,5,ISLAM ALI,Aazad Samaj Party (Kanshi Ram),180,1,181,0.11
494,46,CHHATARPUR,8,NARENDER,Nationalist Congress Party,173,0,173,0.11
495,46,CHHATARPUR,9,DAYA RAM GURJAR,Independent,164,3,167,0.1
496,46,CHHATARPUR,6,RICHA KUMARI,Republican Sena,77,0,77,0.05
497,47,DEOLI,2,PREM CHAUHAN,Aam Aadmi Party,86774,115,86889,55.09
498,47,DEOLI,4,DEEPAK TANWAR,Lok Janshakti Party(Ram Vilas),50124,85,50209,31.83
499,47,DEOLI,3,RAJESH CHAUHAN,Indian National Congress,12147,64,12211,7.74
500,47,DEOLI,1,ASMITA,Bahujan Samaj Party,2569,12,2581,1.64
501,47,DEOLI,7,RAJA RAM,Bhartiya Rashtrawadi Party,2225,4,2229,1.41
502,47,DEOLI,8,NOTA,None of the Above,2116,14,2130,1.35
503,47,DEOLI,6,BACHAN RAM,Matrubhoomi Sewa Party,943,4,947,0.6
504,47,DEOLI,5,DEVIKA,Rashtriya Lok Janshakti Party,536,2,538,0.34
505,48,AMBEDKAR NAGAR,1,DR. AJAY DUTT,Aam Aadmi Party,46122,163,46285,47.62
506,48,AMBEDKAR NAGAR,2,KHUSHI RAM CHUNAR,Bharatiya Janata Party,41877,178,42055,43.27
507,48,AMBEDKAR NAGAR,3,JAI PRAKASH,Indian National Congress,7129,43,7172,7.38
508,48,AMBEDKAR NAGAR,10,NOTA,None of the Above,497,1,498,0.51
509,48,AMBEDKAR NAGAR,4,SEWA DASS,Bahujan Samaj Party,390,7,397,0.41
510,48,AMBEDKAR NAGAR,5,ARUN,Haryana Jansena Party,302,0,302,0.31
511,48,AMBEDKAR NAGAR,7,DARSAN SINGH,Aazad Samaj Party (Kanshi Ram),255,6,261,0.27
512,48,AMBEDKAR NAGAR,9,ASHOK KUMAR,Independent,101,1,102,0.1
513,48,AMBEDKAR NAGAR,8,RAJIV KUMAR,Bhartiya Rashtrawadi Party,85,0,85,0.09
514,48,AMBEDKAR NAGAR,6,GULSHAN BHARTI,Right to Recall Party,32,0,32,0.03
515,49,SANGAM VIHAR,1,CHANDAN KUMAR CHOUDHARY,Bharatiya Janata Party,53980,69,54049,42.99
516,49,SANGAM VIHAR,3,DINESH MOHANIYA,Aam Aadmi Party,53658,47,53705,42.72
517,49,SANGAM VIHAR,4,HARSH CHOUDHARY,Indian National Congress,15840,23,15863,12.62
518,49,SANGAM VIHAR,2,MOHD ZAKIULLAH,Bahujan Samaj Party,795,1,796,0.63
519,49,SANGAM VIHAR,12,NOTA,None of the Above,534,3,537,0.43
520,49,SANGAM VIHAR,9,JAGDISH KUMAR VERMA,Independent,195,0,195,0.16
521,49,SANGAM VIHAR,8,SUDHIR NEGI,Matrubhoomi Sewa Party,143,0,143,0.11
522,49,SANGAM VIHAR,10,MAHENDER KUMAR,Independent,136,0,136,0.11
523,49,SANGAM VIHAR,7,SIRAJUDDIN,Aazad Samaj Party (Kanshi Ram),83,0,83,0.07
524,49,SANGAM VIHAR,5,QAMAR ALI,Nationalist Congress Party,78,0,78,0.06
525,49,SANGAM VIHAR,6,RAVINDER SINGH,Republican Sena,68,0,68,0.05
526,49,SANGAM VIHAR,11,SATPAL,Independent,61,0,61,0.05
527,50,GREATER KAILASH,3,SHIKHA ROY,Bharatiya Janata Party,49370,224,49594,47.74
528,50,GREATER KAILASH,4,SAURABH BHARADWAJ,Aam Aadmi Party,46231,175,46406,44.67
529,50,GREATER KAILASH,1,GARVIT SINGHVI,Indian National Congress,6677,34,6711,6.46
530,50,GREATER KAILASH,7,NOTA,None of the Above,666,5,671,0.65
531,50,GREATER KAILASH,2,NIYATI CHOUDHARY,Bahujan Samaj Party,235,0,235,0.23
532,50,GREATER KAILASH,6,SATISH KUMAR GULLIYA,Bhartiya Rashtrawadi Party,171,0,171,0.16
533,50,GREATER KAILASH,5,RAMESH JAGANNATH SHAH,Delhi Janta Party,96,0,96,0.09
534,51,KALKAJI,2,ATISHI,Aam Aadmi Party,52058,96,52154,48.8
535,51,KALKAJI,4,RAMESH BIDHURI,Bharatiya Janata Party,48478,155,48633,45.5
536,51,KALKAJI,1,ALKA LAMBA,Indian National Congress,4367,25,4392,4.11
537,51,KALKAJI,14,NOTA,None of the Above,556,0,556,0.52
538,51,KALKAJI,3,PRITAM SINGH,Bahujan Samaj Party,421,0,421,0.39
539,51,KALKAJI,5,TANYA SINGH,Bhartiya Rashtrawadi Party,193,0,193,0.18
540,51,KALKAJI,6,DEEPAK KAPILA,Azad Adhikar Sena,173,1,174,0.16
541,51,KALKAJI,13,SANJAY,Independent,89,0,89,0.08
542,51,KALKAJI,7,RAJAN SINGH,Aam Janta Party (India),84,1,85,0.08
543,51,KALKAJI,11,PARVEEN CHOUDHRY,Independent,58,0,58,0.05
544,51,KALKAJI,12,RAVI,Independent,39,0,39,0.04
545,51,KALKAJI,10,IQBAL AHMED SIDDIQUI,Independent,31,0,31,0.03
546,51,KALKAJI,9,SANGH MITRA,Bhim Sena,28,0,28,0.03
547,51,KALKAJI,8,RAJESH KUMAR,Veer Janshakti Party,23,0,23,0.02
548,52,TUGHLAKABAD,4,SAHI RAM,Aam Aadmi Party,62073,82,62155,54.08
549,52,TUGHLAKABAD,2,ROHTASH KUMAR,Bharatiya Janata Party,47362,82,47444,41.28
550,52,TUGHLAKABAD,3,VIRENDER SINGH,Indian National Congress,2303,10,2313,2.01
551,52,TUGHLAKABAD,1,AMJAD HASAN,Bahujan Samaj Party,1604,2,1606,1.4
552,52,TUGHLAKABAD,10,NOTA,None of the Above,534,2,536,0.47
553,52,TUGHLAKABAD,8,PARVEEN CHAUHAN,Samata Party,323,0,323,0.28
554,52,TUGHLAKABAD,7,NARESH KUMAR,Right to Recall Party,199,0,199,0.17
555,52,TUGHLAKABAD,9,REKHA SINGH,Independent,143,0,143,0.12
556,52,TUGHLAKABAD,5,KHURSHEED ABBAS ZAIDI,Rashtriya Bahujan Congress Party,133,0,133,0.12
557,52,TUGHLAKABAD,6,CHAMAN LAL,Peoples Party of India (Democratic),86,0,86,0.07
558,53,BADARPUR,5,RAM SINGH NETAJI,Aam Aadmi Party,112809,182,112991,54.3
559,53,BADARPUR,3,NARAYAN DUTT SHARMA,Bharatiya Janata Party,86865,238,87103,41.86
560,53,BADARPUR,1,ARJUN SINGH BHADANA,Indian National Congress,3135,10,3145,1.51
561,53,BADARPUR,4,PARDEEP,Bahujan Samaj Party,1955,10,1965,0.94
562,53,BADARPUR,13,NOTA,None of the Above,908,7,915,0.44
563,53,BADARPUR,9,RAHUL RAI,Samata Party,466,0,466,0.22
564,53,BADARPUR,2,JAGDISH CHAND,Communist Party of India  (Marxist),363,4,367,0.18
565,53,BADARPUR,6,IMRAN SAIFI,Nationalist Congress Party,322,0,322,0.15
566,53,BADARPUR,12,DEEPAK RAWAT,Independent,219,0,219,0.11
567,53,BADARPUR,10,HARI RAM,Rashtriya Bahujan Congress Party,185,0,185,0.09
568,53,BADARPUR,11,OM PRAKASH GUPTA,Independent,176,0,176,0.08
569,53,BADARPUR,8,RAM BAHADUR,Akhil Bhartiya Manavatavadi Party,133,1,134,0.06
570,53,BADARPUR,7,BRIJPAL,Bharatiya Sampuran Krantikari Party,107,0,107,0.05
571,54,OKHLA,1,AMANATULLAH KHAN,Aam Aadmi Party,88751,192,88943,42.45
572,54,OKHLA,3,MANISH CHAUDHARY,Bharatiya Janata Party,65157,147,65304,31.17
573,54,OKHLA,11,SHIFA UR REHMAN KHAN,All India Majlis-E-Ittehadul Muslimeen,39498,60,39558,18.88
574,54,OKHLA,2,ARIBA KHAN,Indian National Congress,12638,101,12739,6.08
575,54,OKHLA,4,SATISH KUMAR,Bahujan Samaj Party,755,1,756,0.36
576,54,OKHLA,15,NOTA,None of the Above,600,4,604,0.29
577,54,OKHLA,12,SHER MOHAMMAD,Azad Samaj Party,287,3,290,0.14
578,54,OKHLA,13,SHEIKH ARSALAN ULLAH CHISHTI,Independent,270,0,270,0.13
579,54,OKHLA,5,MD INJAMAMUL HASSAN,Communist Party of India,259,0,259,0.12
580,54,OKHLA,10,RIZWANA KHATOON,Socialist Unity Centre Of India (COMMUNIST),221,0,221,0.11
581,54,OKHLA,14,HAMMAD KHAN,Independent,180,0,180,0.09
582,54,OKHLA,9,FIRDOS ALAM,Bhartiya Insan Party,148,0,148,0.07
583,54,OKHLA,7,KANEEZ FATIMA,Aihra National Party,126,0,126,0.06
584,54,OKHLA,6,MOHD ISLAM,Right to Recall Party,83,0,83,0.04
585,54,OKHLA,8,JAMALUDDIN,Buland Bharat Party,41,0,41,0.02
586,55,TRILOKPURI,4,RAVI KANT,Bharatiya Janata Party,58029,188,58217,46.1
587,55,TRILOKPURI,2,ANJANA PARCHA,Aam Aadmi Party,57692,133,57825,45.79
588,55,TRILOKPURI,1,AMARDEEP,Indian National Congress,6115,32,6147,4.87
589,55,TRILOKPURI,5,VICKY,Aazad Samaj Party (Kanshi Ram),1677,4,1681,1.33
590,55,TRILOKPURI,3,NAND LAL,Bahujan Samaj Party,1309,13,1322,1.05
591,55,TRILOKPURI,8,NOTA,None of the Above,679,4,683,0.54
592,55,TRILOKPURI,7,NAVEEN RAM,Independent,272,0,272,0.22
593,55,TRILOKPURI,6,SARITA SINGH,Akhil Bharatiya Socialist Party,133,3,136,0.11
594,56,KONDLI,2,KULDEEP KUMAR (MONU),Aam Aadmi Party,61609,183,61792,48
595,56,KONDLI,3,PRIYANKA GAUTAM,Bharatiya Janata Party,55243,256,55499,43.11
596,56,KONDLI,1,AKSHAY KUMAR,Indian National Congress,7173,57,7230,5.62
597,56,KONDLI,4,MUKESH KUMAR,Bahujan Samaj Party,2388,50,2438,1.89
598,56,KONDLI,10,NOTA,None of the Above,771,5,776,0.6
599,56,KONDLI,8,SUNNY KUMAR,Aazad Samaj Party (Kanshi Ram),411,7,418,0.32
600,56,KONDLI,6,ASHA KAMBLE,Republican Party of India (Athawale),188,0,188,0.15
601,56,KONDLI,9,SURENDER SINGH,Swaraj Bhartiya Nyay Party,166,1,167,0.13
602,56,KONDLI,7,NIKHIL KUMAR PIPAL,Right to Recall Party,121,1,122,0.09
603,56,KONDLI,5,AMARJEET PRASAD,Communist Party of India  (Marxist-Leninist)  (Liberation),94,6,100,0.08
604,57,PATPARGANJ,4,Ravinder Singh Negi (Ravi Negi),Bharatiya Janata Party,73696,364,74060,53.41
605,57,PATPARGANJ,2,AVADH OJHA,Aam Aadmi Party,45856,132,45988,33.17
606,57,PATPARGANJ,1,ANIL KUMAR,Indian National Congress,16454,95,16549,11.94
607,57,PATPARGANJ,3,OM SHANKAR PANDEY,Bahujan Samaj Party,747,9,756,0.55
608,57,PATPARGANJ,10,NOTA,None of the Above,688,4,692,0.5
609,57,PATPARGANJ,7,PRAKASH CHANDRA JOSHI,Bhartiya Rashtriya Jansatta,187,1,188,0.14
610,57,PATPARGANJ,5,GOPAL PRASAD,Delhi Janta Party,137,0,137,0.1
611,57,PATPARGANJ,9,DIBLU SINGH,Independent,114,3,117,0.08
612,57,PATPARGANJ,8,JAGDISH  OJHA,Independent,108,0,108,0.08
613,57,PATPARGANJ,6,DEEPA DEVI,Aihra National Party,55,2,57,0.04
614,58,LAXMI NAGAR,1,ABHAY VERMA,Bharatiya Janata Party,65560,298,65858,52.11
615,58,LAXMI NAGAR,2,B B TYAGI,Aam Aadmi Party,54148,168,54316,42.98
616,58,LAXMI NAGAR,4,SUMIT SHARMA,Indian National Congress,4277,39,4316,3.42
617,58,LAXMI NAGAR,16,NOTA,None of the Above,680,6,686,0.54
618,58,LAXMI NAGAR,3,MOHD WAQAR CHOUDHARY,Bahujan Samaj Party,382,6,388,0.31
619,58,LAXMI NAGAR,8,GANDHI GAUTAM,Aazad Samaj Party (Kanshi Ram),172,1,173,0.14
620,58,LAXMI NAGAR,12,VIKAS,Aapsi Sahyog Party,133,2,135,0.11
621,58,LAXMI NAGAR,10,DEEPAK PANDEY,Magadh Congress of Inda,107,0,107,0.08
622,58,LAXMI NAGAR,14,JAGDISH KUMAR GARG,Independent,74,0,74,0.06
623,58,LAXMI NAGAR,15,VIMAL KUMAR SAXENA,Independent,69,0,69,0.05
624,58,LAXMI NAGAR,11,NAMAHA,Nationalist Congress Party,48,0,48,0.04
625,58,LAXMI NAGAR,13,ANURAG KUMAR,Independent,48,0,48,0.04
626,58,LAXMI NAGAR,7,KUSUM LATA,Peoples Party of India (Democratic),44,2,46,0.04
627,58,LAXMI NAGAR,5,ANIMA OJHA,Right to Recall Party,45,0,45,0.04
628,58,LAXMI NAGAR,9,DANVEER VIDYALANKAR,Rashtra Nirman Party,41,0,41,0.03
629,58,LAXMI NAGAR,6,ISMAIL,Voice of Awam Party,32,0,32,0.03
630,59,VISHWAS NAGAR,1,OM PRAKASH SHARMA,Bharatiya Janata Party,71672,469,72141,57.7
631,59,VISHWAS NAGAR,2,DEEPAK SINGHAL,Aam Aadmi Party,46955,144,47099,37.67
632,59,VISHWAS NAGAR,3,RAJIV CHAUDHARY,Indian National Congress,3576,51,3627,2.9
633,59,VISHWAS NAGAR,11,NOTA,None of the Above,1042,5,1047,0.84
634,59,VISHWAS NAGAR,4,RAJESH KUMAR YADAV,Bahujan Samaj Party,436,7,443,0.35
635,59,VISHWAS NAGAR,10,BHAWANA BOTHRA,Veer Janshakti Party,217,0,217,0.17
636,59,VISHWAS NAGAR,6,GURMEET SINGH,Jai Maha Bharath Party,161,0,161,0.13
637,59,VISHWAS NAGAR,9,PARAG JAIN,Aam Aadmi Parivartan Party,142,0,142,0.11
638,59,VISHWAS NAGAR,7,DEEPAK KUMAR,Bharatiy Aam Janta Adhikar Party,47,2,49,0.04
639,59,VISHWAS NAGAR,8,NEELAM SINGH,Peoples Party of India (Democratic),49,0,49,0.04
640,59,VISHWAS NAGAR,5,ANIL KUMAR,National Youth Party,47,0,47,0.04
641,60,KRISHNA NAGAR,1,DR ANIL GOYAL,Bharatiya Janata Party,75623,299,75922,52.94
642,60,KRISHNA NAGAR,4,VIKAS BAGGA CA,Aam Aadmi Party,56332,92,56424,39.35
643,60,KRISHNA NAGAR,3,GURCHARAN SINGH (RAJU),Indian National Congress,9356,37,9393,6.55
644,60,KRISHNA NAGAR,8,NOTA,None of the Above,687,9,696,0.49
645,60,KRISHNA NAGAR,2,AMAR SINGH,Bahujan Samaj Party,544,8,552,0.38
646,60,KRISHNA NAGAR,7,VINOD KAPOOR,Independent,191,0,191,0.13
647,60,KRISHNA NAGAR,5,POONAM MAINI,National Youth Party,131,0,131,0.09
648,60,KRISHNA NAGAR,6,VIDHAYAK VIRENDRA PRADHAN GURJAR,Samrat Mihir Bhoj Samaj Party,96,0,96,0.07
649,61,GANDHI NAGAR,1,ARVINDER SINGH LOVELY,Bharatiya Janata Party,56665,193,56858,53.94
650,61,GANDHI NAGAR,4,NAVEEN CHAUDHARY (DEEPU),Aam Aadmi Party,44059,51,44110,41.85
651,61,GANDHI NAGAR,2,KAMAL ARORA (DABBU),Indian National Congress,3433,20,3453,3.28
652,61,GANDHI NAGAR,7,NOTA,None of the Above,402,0,402,0.38
653,61,GANDHI NAGAR,3,TIKRAJ SINGH,Bahujan Samaj Party,235,0,235,0.22
654,61,GANDHI NAGAR,5,PAWAN CHOUDHRY,Jatiya Jana Sena Party,190,0,190,0.18
655,61,GANDHI NAGAR,6,GULFAM,Independent,156,0,156,0.15
656,62,SHAHDARA,4,SANJAY GOYAL,Bharatiya Janata Party,62477,311,62788,49.63
657,62,SHAHDARA,2,JITENDER SINGH SHUNTY,Aam Aadmi Party,57449,161,57610,45.54
658,62,SHAHDARA,1,JAGAT SINGH,Indian National Congress,3834,28,3862,3.05
659,62,SHAHDARA,3,DHARMINDRA KUMAR KAIM,Bahujan Samaj Party,586,10,596,0.47
660,62,SHAHDARA,10,VINAY CHAUDHARI,Independent,577,2,579,0.46
661,62,SHAHDARA,11,NOTA,None of the Above,555,3,558,0.44
662,62,SHAHDARA,6,NITIN GARG,Aam Aadmi Parivartan Party,181,1,182,0.14
663,62,SHAHDARA,5,KAMAL KISHORE,National Youth Party,145,0,145,0.11
664,62,SHAHDARA,8,ASHOK SURANA,Independent,87,0,87,0.07
665,62,SHAHDARA,7,RAJENDRA KUMAR PAL,Nationalist Congress Party,58,0,58,0.05
666,62,SHAHDARA,9,DILIP BANERJEE,Independent,52,0,52,0.04
667,63,SEEMAPURI,4,VEER SINGH DHINGAN,Aam Aadmi Party,66186,167,66353,48.45
668,63,SEEMAPURI,3,KU. RINKU,Bharatiya Janata Party,55766,219,55985,40.88
669,63,SEEMAPURI,2,RAJESH LILOTHIA,Indian National Congress,11788,35,11823,8.63
670,63,SEEMAPURI,1,MANOJ,Bahujan Samaj Party,855,12,867,0.63
671,63,SEEMAPURI,6,ANIL KUMAR,Aazad Samaj Party (Kanshi Ram),650,4,654,0.48
672,63,SEEMAPURI,12,NOTA,None of the Above,453,5,458,0.33
673,63,SEEMAPURI,5,AJAY KUMAR,Peoples Party of India (Democratic),276,1,277,0.2
674,63,SEEMAPURI,10,SAROJ BALA,Swatantra Jantaraj Party,163,0,163,0.12
675,63,SEEMAPURI,11,ASHISH KUMAR,Independent,158,0,158,0.12
676,63,SEEMAPURI,9,RAJESH KUMAR LOHIYA,Nationalist Congress Party,110,0,110,0.08
677,63,SEEMAPURI,7,CHARAN SINGH MALIYAN,Right to Recall Party,58,0,58,0.04
678,63,SEEMAPURI,8,RAJESH,Bharatiya Sarvodaya Kranti Party,50,1,51,0.04
679,64,ROHTAS NAGAR,2,JITENDER MAHAJAN,Bharatiya Janata Party,82299,597,82896,57.44
680,64,ROHTAS NAGAR,3,SARITA SINGH,Aam Aadmi Party,54803,191,54994,38.11
681,64,ROHTAS NAGAR,4,SURESHVATI,Indian National Congress,3604,35,3639,2.52
682,64,ROHTAS NAGAR,1,ASHOK KUMAR,Bahujan Samaj Party,930,23,953,0.66
683,64,ROHTAS NAGAR,16,NOTA,None of the Above,628,2,630,0.44
684,64,ROHTAS NAGAR,14,VIKAS TYAGI,Independent,548,2,550,0.38
685,64,ROHTAS NAGAR,11,SURENDER SINGH VISHWAKARMA,Aazad Samaj Party (Kanshi Ram),172,2,174,0.12
686,64,ROHTAS NAGAR,6,ABHISHEK,Nationalist Congress Party,91,0,91,0.06
687,64,ROHTAS NAGAR,15,SURESH PAL JAINTH,Independent,72,0,72,0.05
688,64,ROHTAS NAGAR,8,NASEEM USMAN,Bharatiya Liberal Party,63,0,63,0.04
689,64,ROHTAS NAGAR,9,PANKAJ GUPTA,Sarvodaya Prabhat Party,54,0,54,0.04
690,64,ROHTAS NAGAR,5,AKESHAN DUT,Bhartiya Rashtriya Dal,48,0,48,0.03
691,64,ROHTAS NAGAR,13,NITIN MITTAL,Independent,45,0,45,0.03
692,64,ROHTAS NAGAR,7,AMIT KUMAR SHARMA,Sanjhi Virasat Party,42,1,43,0.03
693,64,ROHTAS NAGAR,12,SANJEEV KUMAR,Jan Samuh Party,34,1,35,0.02
694,64,ROHTAS NAGAR,10,SUBHASH CHAND GUPTA,Bhartiya Rashtrawadi Party,30,0,30,0.02
695,65,SEELAM PUR,3,CHAUDHARY ZUBAIR AHMAD,Aam Aadmi Party,78866,143,79009,59.21
696,65,SEELAM PUR,1,ANIL KUMAR SHARMA (GAUR),Bharatiya Janata Party,36353,179,36532,27.38
697,65,SEELAM PUR,2,ABDUL REHMAN,Indian National Congress,16524,27,16551,12.4
698,65,SEELAM PUR,4,DEEPAK KUMAR,Bahujan Samaj Party,415,7,422,0.32
699,65,SEELAM PUR,14,NOTA,None of the Above,353,2,355,0.27
700,65,SEELAM PUR,6,SHABANA,Rashtriya Republican Party,177,0,177,0.13
701,65,SEELAM PUR,5,MOHD NAZIR,Republican Party of India (Athawale),107,0,107,0.08
702,65,SEELAM PUR,12,MOHD SHAFI,Independent,72,0,72,0.05
703,65,SEELAM PUR,7,SUMAN SHARMA,Sanjhi Virasat Party,50,0,50,0.04
704,65,SEELAM PUR,13,SYED MUNEEB,Independent,46,0,46,0.03
705,65,SEELAM PUR,11,RAHISUDDIN AHMAD,Independent,44,0,44,0.03
706,65,SEELAM PUR,10,MOHD ZUBAIR MALIK,Independent,29,0,29,0.02
707,65,SEELAM PUR,8,S. M. AQIF,Independent,24,0,24,0.02
708,65,SEELAM PUR,9,ISLAUDDIN,Independent,22,0,22,0.02
709,66,GHONDA,1,AJAY MAHAWAR,Bharatiya Janata Party,79706,281,79987,56.96
710,66,GHONDA,2,GAURAV SHARMA,Aam Aadmi Party,53828,101,53929,38.41
711,66,GHONDA,3,BHISHAM SHARMA,Indian National Congress,4859,24,4883,3.48
712,66,GHONDA,10,NOTA,None of the Above,587,1,588,0.42
713,66,GHONDA,4,SUNDER LOHIYA,Bahujan Samaj Party,448,6,454,0.32
714,66,GHONDA,9,GAURAV SHARMA,Independent,277,2,279,0.2
715,66,GHONDA,6,BABITA,Yuva Bharat Rashtraseva Party,114,0,114,0.08
716,66,GHONDA,8,SHUBHAM,Right to Recall Party,84,0,84,0.06
717,66,GHONDA,5,ANIL SINGH,Sanjhi Virasat Party,56,0,56,0.04
718,66,GHONDA,7,ADVOCATE MEHAK DOGRA,Nationalist Congress Party,44,2,46,0.03
719,67,BABARPUR,2,GOPAL RAI,Aam Aadmi Party,76031,161,76192,53.19
720,67,BABARPUR,1,ANIL KUMAR VASHISHT,Bharatiya Janata Party,56758,440,57198,39.93
721,67,BABARPUR,3,MOHD ISHRAQ KHAN,Indian National Congress,8777,20,8797,6.14
722,67,BABARPUR,9,NOTA,None of the Above,471,3,474,0.33
723,67,BABARPUR,5,MD NAZIR,Aman Samaj Party,201,0,201,0.14
724,67,BABARPUR,8,MOHAMMAD ABDULLAH ANSARI,Independent,124,0,124,0.09
725,67,BABARPUR,4,BHUPENDER YADAV,Janhit Dal,93,0,93,0.06
726,67,BABARPUR,7,SHIV KUMAR(KAKE),Sarvodaya Prabhat Party,89,0,89,0.06
727,67,BABARPUR,6,MANOJ KUMAR,Akhil Bharatiya Socialist Party,75,1,76,0.05
728,68,GOKALPUR,4,SURENDRA KUMAR,Aam Aadmi Party,80086,418,80504,48.48
729,68,GOKALPUR,2,PRAVEEN NIMESH,Bharatiya Janata Party,71764,533,72297,43.54
730,68,GOKALPUR,1,ISHWAR SINGH,Indian National Congress,5840,65,5905,3.56
731,68,GOKALPUR,6,ARVIND KUMAR,Aazad Samaj Party (Kanshi Ram),3049,37,3086,1.86
732,68,GOKALPUR,3,LAL SINGH,Bahujan Samaj Party,2518,44,2562,1.54
733,68,GOKALPUR,13,NOTA,None of the Above,589,12,601,0.36
734,68,GOKALPUR,5,ATUL KUMAR,Swaraj Bhartiya Nyay Party,335,4,339,0.2
735,68,GOKALPUR,9,DHARAMVIR SINGH,Peoples Party of India (Democratic),193,2,195,0.12
736,68,GOKALPUR,10,BIR SAIN,Bharatiya Sarvodaya Kranti Party,145,0,145,0.09
737,68,GOKALPUR,12,SURESHPAL JAINTH,Independent,130,3,133,0.08
738,68,GOKALPUR,11,MANJEET SINGH,Jan Samuh Party,125,4,129,0.08
739,68,GOKALPUR,7,CHARAN SINGH MALIYAN,Right to Recall Party,91,0,91,0.05
740,68,GOKALPUR,8,JAGDISH,Nationalist Congress Party,64,0,64,0.04
741,69,MUSTAFABAD,4,MOHAN SINGH BISHT,Bharatiya Janata Party,84888,327,85215,42.36
742,69,MUSTAFABAD,3,ADEEL AHMAD KHAN,Aam Aadmi Party,67511,126,67637,33.62
743,69,MUSTAFABAD,7,MOHD. TAHIR HUSSAIN,All India Majlis-E-Ittehadul Muslimeen,33467,7,33474,16.64
744,69,MUSTAFABAD,1,ALI MEHDI,Indian National Congress,11732,31,11763,5.85
745,69,MUSTAFABAD,2,ASHOK KUMAR,Bahujan Samaj Party,1201,22,1223,0.61
746,69,MUSTAFABAD,13,NOTA,None of the Above,451,4,455,0.23
747,69,MUSTAFABAD,8,DHARAM PAL,Bharatiya Sarvodaya Kranti Party,391,0,391,0.19
748,69,MUSTAFABAD,5,ASHA CHAUDHARY,Bharatiya Sampuran Krantikari Party,236,0,236,0.12
749,69,MUSTAFABAD,11,SAGAR TANHA,Peace Party,227,0,227,0.11
750,69,MUSTAFABAD,10,VISHAL,Peoples Party of India (Democratic),191,1,192,0.1
751,69,MUSTAFABAD,6,MOHD USMAN BAKHSH,Rashtriya Janmorcha,151,0,151,0.08
752,69,MUSTAFABAD,12,JITENDER KUMAR,Independent,122,0,122,0.06
753,69,MUSTAFABAD,9,NASIRUDDIN GAURI,Rashtriya Republican Party,75,0,75,0.04
754,70,KARAWAL NAGAR,2,KAPIL MISHRA,Bharatiya Janata Party,106963,404,107367,53.39
755,70,KARAWAL NAGAR,4,MANOJ KUMAR TYAGI,Aam Aadmi Party,83843,169,84012,41.78
756,70,KARAWAL NAGAR,5,DR. P.K. MISHRA,Indian National Congress,3908,13,3921,1.95
757,70,KARAWAL NAGAR,3,DEVENDRA BHAIYA,Bahujan Samaj Party,1876,11,1887,0.94
758,70,KARAWAL NAGAR,13,AJAY SINGH NEGI,Independent,1002,4,1006,0.5
759,70,KARAWAL NAGAR,16,NOTA,None of the Above,706,3,709,0.35
760,70,KARAWAL NAGAR,12,H.M. HASHIM MALIK,Social Democratic Party Of India,491,0,491,0.24
761,70,KARAWAL NAGAR,1,ASHOK AGARWAL,Communist Party of India  (Marxist),456,1,457,0.23
762,70,KARAWAL NAGAR,7,PRAKASH CHAND,Bahujan Dravida Party,278,0,278,0.14
763,70,KARAWAL NAGAR,14,YOGESH SWAMY,Independent,228,1,229,0.11
764,70,KARAWAL NAGAR,15,VISHAL SHARMA,Independent,173,0,173,0.09
765,70,KARAWAL NAGAR,10,SANJAY MISHRA (SITARAM),Nationalist Congress Party,165,0,165,0.08
766,70,KARAWAL NAGAR,9,SEEMA,Peoples Party of India (Democratic),128,0,128,0.06
767,70,KARAWAL NAGAR,6,NEERAJ,New India United Party,100,0,100,0.05
768,70,KARAWAL NAGAR,8,YOGENDER,Bharatiya Sampuran Krantikari Party,89,1,90,0.04
769,70,KARAWAL NAGAR,11,SANDHIYA TIWARI,Akhil Bharatiya Socialist Party,70,1,71,0.04
